15 15
###############
###         ###
#    #####    #
#             #
###############
#     7     18#
#             #
#  #          #
#       #     #
#             #
#    #        #
#         #   #
#             #
#             #
###############
14
Player @ 1 7
Box 3 1 4
Box 3 2 4
Box = 3 4
Box 6 1 10
Box 6 2 10
Box = 3 10
Player @ 7 7
Box 3 7 12
Box * 5 9
Box 4 7 8
Box + 5 3
Box = 9 8
Box = 10 8
