18 18
##################
#                #
#    34          #
#    56          #
#                #
#                #
#                #
#                #
#                #
#                #
#                #
#                #
#                #
#                #
#                #
#                #
#                #
##################
8
Player @ 3 2
Player @ 3 3
Player @ 4 2
Player @ 4 3
Box 3 6 6
Box 4 2 5
Box 5 7 6
Box 6 2 4
