12 11
###########
#         #
# #       #
# #       #
#         #
###########
#       6 #
# #  5    #
# #       #
# #       #
#         #
###########
11
Player @ 2 1
Player @ 8 1
Box 1 6 6
Box 2 2 5
Box 3 8 4
Box 4 7 7
Box 7 2 8
Box - 3 6
Box + 8 7
Box = 5 5
Box = 9 6
